111111211211111
111111211111111
111111111111111
111111111111111
221111111121112
111111111121111
111111111121111
222222111111111
111111211111111
111111211111111
111111211111111
111111211111111
111111211122211
111111211111211
111111111111111
111111111111111
111111111111111
111111122111111
111111121111111
111111121111111
