111111110000777
111111110000777
111111110000777
111111110000000
111111111111111
111111111111111
001111111111111
001111111111111
001111111111111
001110001111111
001110001111111
001110001111111
001110001111111
000011111111111
000011111111111
000011111111111
000011111111111
666011111111111
666011100000111
666011100000111
