111111111111111
111111111111111
111111111111111
111122222221111
111211111112111
111211111112111
111211111112111
111211111112111
111211111112111
111211111112111
111211111112111
111211111112111
111211111112111
111111111112111
111111111112111
111111111112111
111122222221121
111111111111111
111111111111111
111111111111111
