112211111111111
112218888888881
112218111111181
111118122211181
188888112211181
111181111111181
222181111888881
222181221811111
141181211812221
158881221811121
111111211888111
211111111118881
222111111111181
112111122211181
111111111111181
188888188888881
181118881111181
181211881222181
081221881111181
011111111111111