112211111111111
112211111111111
112211111111111
111111122211111
111111112211111
111111111111111
222111111111111
222111221111111
111111211112221
111111221111121
111111211111111
211111111111111
222111111111111
112111122211111
111111111111111
111111111111111
111111111111111
111211111222111
111221111111111
111111111111111